                 ####################  
           ######////////////////////##
      #####///////////////////////////#
   ###////////////////////////////////#
  #///////////////////////////////////#
 #///////////////////////////////////#
 #///////////////////////////////////#
#////////////////////////////////////#
####/////////////////////////////////#
    ###////////////////////##########
       ###/////////////####
          ###///////###
             ###///#
                ###
