   ####                
  #////###             
  #///////###          
  #//////////###       
  #/////////////###    
 #/////////////////### 
 #////////////////////#
 #////////////////////#
 #////////////////////#
#////////////////////# 
#////////////////////# 
#////////////////////# 
 #///////////////////# 
 #////////////////////#
  #/////////////////###
  #///////////////##   
   #///////////###     
    #///////###        
     #///###           
      ###              
